  11111
 10P0C01
10000E001
 10P0C01
  11111