1111111111
1P000100C1
100E010001
1111111111