1111111111
1P000100E1
100C010001
1111111111