11111111111111111111
1P000000000000000001
10001111111111111001
10001000000000001001
10001011111111001001
10001010000001001001
10001010111101001001
10001010100101001001
10001010100101001001
10001010100101001001
10001010100101001001
10001010100101001001
10001010000101001001
10001011111101001001
10001000000001001001
10001111111111001001
10000000000000001001
1000000C00000000X001
1000000000000000C0E1
11111111111111111111